# Level 13 - Pattern khó
X333333333X0
XX22222222X0
XXX111111XX0
XX22222222X0
X333333333X0
