TS00STTS00ST
SS00SSSS00SS
00T000000T00
0SSS0000SSS0
000000000000
